##############
#O#     a   O#
# # #### #####
#  P   a     #
#    a    ####
#      aO    #
#    a    ####
#O          O#
##############