##############
#     a   O  #
#            #
#  P   a O   #
#    a       #
#      aO    #
#    a       #
#O          O#
##############