##############
#O          O#
###          #
#     a      #
#   a        #
#     a    O #
#          ##
# a   P     O#
############## 